111111111111111
1E010C11000C0P1
100000C01011111
101C010000C0011
1C11C00100010C1
111111111111111